********************
*******            *
S     ** ** * ******
***** ** ** * ***  K
***** ** ** * *** **
***** ** ** * *** **
***** ******* *** **
**        *** *** **
** ******         **
********************